GGGGGGGGGGGGGGGGGGGGGGGGGGGGGGGGGGGGGGGGGGGGGGGGGGGGGGGGGGGGGGGG
GGGGRRGGGGGGGGGGGGGGGGGGGGGGGGGGGGGGGRRGGGGGGGGGGGGGGGGGGGGGGGGG
GGGRRRRRGGGGGGGGGGGGGGGGGGGGGGGGGGGRRRRRGGGGGGGGGGGGGGGGGGGGGGGG
GGGGRRRRRGGGGGGGGGGGGGGGGGGGGGGGGGGRRRRRRGGGGGGGGGGGGGGGGGGGGGGG
GGGGGRRRGGGGGGGGGGGGGGGGGGGGGGGGGGGGGRRRGGGGGGGGGGGGGGGGGGGGGGGG
GGGGGGGGGGGGGGGGGGGGGGGGGGGGGGGGGGGGGGGGGGGGGGGGGGGGGGGGGGGGGGGG
TTTTTTTTTTTTTTTTTTGGGGGGGGGGGGGGGGGGGGGGGGGGGGGGGGGGGGGGGGGGGGGG
XTTTTTTTTTTTTTTTPTGGGGGGGGGGGGGGGGGGGGGGGGGGGGGGGGGGGGGGGGGGGGGG
TTTTTTTTTTTTTTTTTTGGGGGGGGGGGGGGGGGGGGGGGGGGGGGGGGGGGGGGGGGGGGGG
GGGGGGGGGGGGGGGTTTGGGGGGGGGGGGTTTTTTTTTTTTTTTTTTTTTTTTTGGGGGGGGG
GGGGGGGGGGGGGGGTTTGGGGGGGGGGGGTPTTTTTTTTTTTTTTTTTTTTTPTGGGGGGGGG
GGGGGGGGGGGGGGGTTTGGGGGGGGGGGGTTTTTTTTTTTTTTTTTTTTTTTTTGGGGGGGGG
GGGGGGGGGGGGGGGTTTGGGGGGGGGGGGTTTGGGGGGGGGGGGGGGGGGGTTTGGGGGGGGG
GGGGGGGGGGGGGGGTTTGGGGGGGGGGGGTTTGGGGGGGGGGGGGGGGGGGTTTGGGGGGGGG
GGGGGGGGGGGGGGGTTTGGGGGGGGGGGGTTTGGGGGGGGGGGGGGGGGGGTTTGGGGGGGGG
GGGGGGGGGGGGGGGTTTGGGGGGGGGGGGTTTGGGGGGGGGGGGGGGGGGGTTTGGGGGGGGG
GGGGGGGGGGGGGGGTTTGGGGGGGGGGGGTTTGGGGGGGGGGGGGGGGGGGTTTGGGGRRGGG
GGGGGGGGGGGGGGGTTTGGGRRGGGGGGGTTTGGGGGGGGGGGGGGGGGGGTTTGGGRRRGGG
GGGGGGWWGGGGGGGTTTGRRRRRGGGGGGTTTGGGGGGGGGGGGGGGGGGGTTTGGGRRRRGG
GGGGWWWWWGGGGGGTTTGRRRRRGGGGGGTTTGGGGGGGTTTTTTTTTTTTTTTGGGRRRRGG
GGWWWWWWWGGGGGGTTTGRRRRRGGGGGGTTTGGGGGGGTPTTTTTTTTTTTPTGGGGGRRGG
GGWWWWWWWGGGGGGTTTGGRRRRGGGGGGTTTGGGGGGGTTTTTTTTTTTTTTTGGGGGGGGG
GGWWWWWWWWGGGGGTTTGGGRRGGGGGGGTTTGGGGGGGTTTGGGGGGGGGGGGGGGGGGGGG
GGWWWWWWWWGGGGGTTTGGGGGGGGGGGGTTTGGGGGGGTTTGGGGGGGGGGGGGGGGGGGGG
GGGGWWWWWWGGGGGTTTGGGGGGGGGGGGTTTGGGGGGGTTTGGGGGGGGGGGGGGGGGGGGG
GGGGWWWWWWGGGGGTTTGGGGGGGGGGGGTTTGGGGGGGTTTGGGGGGGGGGGGGGGGGGGGG
GGGGGWWWGGGGGGGTTTGGGGGGGGGGGGTTTGGGGGGGTTTGGGGGGGGGGGGGGGGGGGGG
GGGGGGGGGGGGGGGTTTGGGGGGGGGGGGTTTGGGGGGGTTTGGGGGGGGGGGGGGGGGGGGG
GGGGGGGGGGGGGGGTTTGGGGGGGGGGGGTTTGGGGGGGTTTGGGGGGGGGGGGGGGGGGGGG
GGGGGGGGGGGGGGGTTTGGGGGGGGGGGGTTTGGGGGGGTTTGGGGGGTTTTTTTTTTTTTTT
GGGGGGGGGGGGGGGTTTGGGGGGGGGGGGTTTGGGGGGGTTTGGGGGGTPTTTTTTTTTTTTZ
GGGGGGGGGGGGGGGTTTGGGGGGGGGGGGTTTGGGGGGGTTTGGGGGGTTTTTTTTTTTTTTT
GGGGRGGGGGGGGGGTTTGGGGGGGGGGGGTTTGGGGGGGTTTGGGGGGTTTGGGGGGGGGGGG
GGGRRRGGGGGGGGGTTTGGGGGGGGGGGGTTTGGGGGGGTTTGGGGGGTTTGGGRGGGGGGGG
GGRRRRGGGGGGGGGTTTGGGGGGGGGGGGTTTGGGGGGGTTTGGGGGGTTTGGRRRGGGGGGG
GGRRRRRGGGGGGGGTTTGGGGGGGGGGGGTTTGGGGGGGTTTGGGGGGTTTGRRRRGGGGGGG
GGRRRGGGGGGGGGGTTTGGGGGGGGGGGGTTTGGGGGGGTTTGGGGGGTTTGRRRRRGGGGGG
GGRGGGGGGGGGGGGTTTGGGGGGGGGGGGTTTGGGGGGGTTTGGGGGGTTTGGRRRRRGGGGG
GGGGGGGGGGGGGGGTTTGGGGGGGGGGGGTTTGGGGGGGTTTGGGGGGTTTGGGRRRRGGGGG
GGGGGGGGGGGGGGGTTTTTTTTTTTTTTTTTTGGGGGGGTTTGGGGGGTTTGGGGRRGGGGGG
GGGGGGGGGGGGGGGTPTTTTTTTTTTTTTTPTGGGGGGGTTTGGGGGGTTTGGGGGGGGGGGG
GGGGGGGGGGGGGGGTTTTTTTTTTTTTTTTTTGGGGGGGTTTGGGGGGTTTGGGGGGGGGGGG
GGGGGGGGGGGGGGGGGGGGGGGGGGGGGGGGGGGGGGGGTTTTTTTTTTTTGGGGGGGGGGGG
GGGGGGGGGGGGGGGGGGGGGGGGGGGGGGGGGGGGGGGGTPTTTTTTTTPTGGGGGGGGGGGG
GGGGGGGGGGGGGGGGGGGGGGGGGGGGGGGGGGGGGGGGTTTTTTTTTTTTGGGGGGGGGGGG
GGGGGGGGGGGGGGGGGGGGGGGGGGGGGGGGGGGGGGGGGGGGGGGGGGGGGGGGGGGGGGGG
GGGGGGGGGGGGGGGGGGGGGGGGGGGGGGGGGGGGGGGGGGGGGGGGGGGGGGGGGGGGGGGG
GGGGGGGGGGGGGGGGGGGGGGGGGGGGGGGGGGGGGGGGGGGGGGGGGGGGGGGGGGGGGGGG
