GGGGGGGGGGTZTGGGGGGGGWWWWWWWGGGGGGGGGGGGGGGGGGGGGGGGGGGGGGGGGGGG
GGGGGGGGGGTTTGGGRRRGGWWWWWWWWGGGGGGGGGGGGGGGGGGGGGGGGGGGGGGGGGGG
GGGGGGGGGGTTTGGRRRRGGWWWWWWWWGGGGGGGGGGGGGGGGGGGGGGGGGRRRRRGGGGG
GGGGGGGGGGTTTGGRRRRRGGWWWWWWWGGGGGGGGGGGGGGGGGGGGGGGGRRRRRRRRGGG
GGGGGGGGGGTTTGRRRRRRGGWWWWWWWGGGGGGGGGGGGGGGGGGGGGGGGRRRRRRRRGGG
GGGGGGGGGGTTTGRRRRRRGGWWWWWWWGGGGGGGGGGGGGGGGGGGGGGGGGRRRRRRRGGG
GGGGGGGGGGTTTGRRRRRGGGGWWWWWWWGGGGGGGGGGGGGGGGGGGGGGGGGGRRRRGGGG
GGGGGGGGGGTTTGGGGGGGGGGWWWWWWWGGGGGGGGGGGGGGGGGGGGGGGGGGGGGGGGGG
GGGGGGGGGGTTTTTTTTTTTTTTTTTTTTTTTTTTTTTTTTTTTTTTTGGGGGGGGGGGGGGG
GGGGGGGGGGTPTTTTTTTTTTTTTTTTTTTTTTTTTTTTTTTTTTTPTGGGGGGGGGGGGGGG
GGGGGGGGGGTTTTTTTTTTTTTTTTTTTTTTTTTTTTTTTTTTTTTTTGGGGGGGGGGGGGGG
GGGGGGGGGGGGGGGGGGGGGGGGWWWWWWGGGGGGGGGGGGGGGGTTTGGGGGGGGGGGGGGG
GGGGGGGRRRRRRGGGGGGGGGGGWWWWWWGGGGGGGGGGGRRRGGTTTGGGGGGGGGGGGGGG
GGGGGGRRRRRRRRRGGGGGGGGGWWWWWWGGGGGGGGGGRRRRGGTTTGGGGGGGGGGGGGGG
GGGGGGRRRRRRRRRGGGGGGGGGWWWWWWWGGGGGGGGRRRRRRGTTTGGGGGGGGGGGGGGG
GGGGGGRRRRRRRRRGGGGGGGGGWWWWWWWGGGGGGGGRRRRRRGTTTGGGGGGGGGGGGGGG
GGGGGGGGRRRRRRGGGGGGGGGGGWWWWWWGGGGGGGGRRRRRRGTTTGGGGGGGGGGGGGGG
GGGGGGGGGRRRRGGGGGGGGGGGGWWWWWWGGGGGGGRRRRRRRGTTTGGGGGGGGGGGGGGG
GGGGGGGGGGGGGGGGGGGGGGGGGGWWWWWWGGGGGGRRRRRRRGTTTGGGGGGGGGGGGGGG
GGGGGGGGGGGGGGGGGGGGGGGGGGWWWWWWGGGGGGRRRRRRGGTTTGGGGGGGGGGGGGGG
GGGGGGGGGGGGGGGGGGGGGGGGGGWWWWWWGGGGGGGGRRRRGGTTTGGGGGGGGGGGGGGG
GGGGGGGGGGGGGGGGGGGGGGGGGGWWWWWWGGGGGGGGGGGGGGTTTGGGGGGGGGGGGGGG
GGGGGGGGGGTTTTTTTTTTTTTTTTTTTTTTTTTTTTTTTTTTTTTTTGGGGGGGGGGGGGGG
GGGGGGGGGGTPTTTTTTTTTTTTTTTTTTTTTTTTTTTTTTTTTTTPTGGGGGGGGGGGGGGG
GGGGGGGGGGTTTTTTTTTTTTTTTTTTTTTTTTTTTTTTTTTTTTTTTGGGGGGGGGGGGGGR
GGGGGGGGGGTTTGGGGGGGGGGGGGGWWWWWGGGGGGGGGGGGGGGGGGGGGGGGGGGGGGGR
GGGGGGGGGGTTTGGGGGGGGGGGGGGWWWWWGGGGGGGGGGGGGGGGGGGGGGGGGGGGGGGR
GGGGGGGGGGTTTGGGGGGGGGGGGGGWWWWWGGGGGGGGGGGGGGGGGGGGGGGGGGGGGGRR
GGGGGGGGGGTTTGGGGGGGGGGGGGGWWWWWGGGGGGGGGGGGGGGGGGGGGGGGGGGGGGRR
GGGGGGGGGGTTTGGGGGGGGGGGGGGGWWWWGGGGGGGGGGGGGGGGGGGGGGGGGGGGGRRR
GGGGGGGGGGTTTGGGGGGGGGGGGGGGWWWWGGGGGGGGGGGGGGGGGGGGGGGGGGGGGRRR
GGGGGGGGGGTTTGGGGGGGGGGGGGGGWWWWGGGGGGGGGGGGGGGGGGGGGGGGGGGGRRRR
GGGGGGGGGGTTTTTTTTTTTTTTTTTTTTTTTTTTTTGGGGGGGGGGGGGGGGGGGGGGRRRR
GGGGGGGGGGTPTTTTTTTTTTTTTTTTTTTTTTTTPTGGGGGGGGGGGGGGGGGGGGGGRRRR
GGGGGGGGGGTTTTTTTTTTTTTTTTTTTTTTTTTTTTGGGGGGGGGGGGGGGGGGGGGRRRRR
GGGGGGGGGGGGGGGGGGGGGGGGGGGGWWWWGGGTTTGGGGGGGGGGGGGGGGGGGGGRRRRR
GGGGGGGGGGGGGGGGGGGGGGGGGGGGWWWWGGGTTTGGGGGGGGGGGGGGGGGGGGRRRRRR
GGGGGGWWWWWWGGGGGGGGGGGGGGGGWWWWGGGTTTGGGGGGGGGGGGGGGGGGGGRRRRRR
GGGGGWWWWWWWWGGGGGGGGGGGGWWWWWWWWGGTTTGGGGGGGGGGGGGGGGGGGGRRRRRR
GGGGWWWWWWWWWWGGGGGGGGGWWWWWWWWWWGGTTTGGGGGRRRGGGGGGGGGGGGRRRRRR
GGGWWWWWWWWWWWGGGWWWWWWWWWWWWWWWWGGTTTGGGGRRRRRRGGGGGGGGGRRRRRRR
GGGWWWWWWWWWWWWWWWWWWWWWGGGGGWWWWGGTTTGGGGGRRRRRRGGGGGGGGRRRRRRR
GGGWWWWWWWWWWWWWWWGGGGGGGGGGGWWWWGGTTTGGGGGRRRRRRGGGGGGGGRRRRRRR
GGGWWWWWWWWWWWWGGGGGGGGGGGGGGGWWWGGTTTGGGGGGRRRRRRGGGGGGGRRRRRRR
GGGWWWWWWWWWWWGGGGGGGGGGGGGGGGWWWGGTTTGGGGGGGGRRRRRGGGGGRRRRRRRR
GGGGWWWWWWWWWGGGGGGGGGGGGGGGGGWWWGGTTTGGGGGGGGGRRRGGGGGGRRRRRRRR
GGGGGWWWWWWWGGGGGGGGGGGGGGGGGGWWWGGTTTGGGGGGGGGGGGGGGGGGRRRRRRRR
GGGGGGGGGGGGGGGGGGGGGGGGGGGGGGWWWGGTZTGGGGGGGGGGGGGGGGGGRRRRRRRR
